    NO ./textures/cañamo.xpm
    SO       ./textures/verde.xpm
    WE ./textures/cristal.xpm      
    EA ./textures/madera.xpm
    F      0,126,100       
    C  120,128,100       

11111
00011
 
        1111111111111111111111111111
        1000000000001100000000000001
        1011000001110000110000001111
        1001000000000001  10000000001   
111111111011000001110000110000001   
100000000000000001110111111111111   
11110111111111N11000000010001       
11110101111111011101010010001
11000000110101011100000000001
10000111111111111111111111111
11111111111111111111111111111