    NO ./textures/cañamo.xpm
    SO       ./textures/cristal.xpm
    WE ./textures/verde.xpm       
    EA ./textures/madera4.xpm
    F      160,150,100       
    C  210,126,100       

11111
10001
100N1
11111