    NO ./textures/cañamo.xpm
    SO       ./textures/cristal.xpm
    WE ./textures/verde.xpm       
    EA ./textures/madera4.xpm
    F      160,150,100       
    C  210,126,100       


        1111111111111111111111111111
        1001N01011000000000000001
        1011100001110000000000001111
        1001000000000000000000001   
111111111011001001110000000000001   
10000000000001 101110111111111111   
11110111111111111000000010001       
11110101111111011101010010001
11000000110101011100000000001
10000111111111111111111111111
11111111111111111111111111111