11111111111111
10001100000001
100N0000000001
10000000000111
11111111111111