    NO ./textures/cañamo.xpm
    SO       ./textures/cristal.xpm
    WE ./textures/verde.xpm       
    EA ./textures/madera4.xpm
    F      160,150,100       
    C  210,126,100       

111111111111111111
100000000000000001
100000000000000001
1000000000N0000001
100000000000000001
100000000000000001
100000000000000001
111111111111111111